#### #### #### #### #### #### #### #### #### #### #### #### #### #### #### #### #### #### #### #### ####
####   27   19   21   25   53   25   21   21   31 ####   31   21   21   25   53   25   21   19   27 ####
####   19 #### #### ####   33 #### #### ####   26 ####   26 #### #### ####   33 #### #### ####   19 ####
####   45   24   28   33   67   37   60   33   56   32   56   33   60   37   67   33   28   24   45 ####
####   19 #### #### ####   36 ####   30 #### #### #### #### ####   30 ####   36 #### #### ####   19 ####
####   27   19   21   27   58 ####   34   22   30 ####   30   22   34 ####   58   27   21   19   27 ####
#### #### #### #### ####   33 #### #### ####   23 ####   23 #### #### ####   33 #### #### #### #### ####
#### -198    2 -198 ####   32 ####   42   29   51   26   51   29   42 ####   32 #### -198    2 -198 ####
#### #### #### #### ####   35 ####   36 #### #### #### #### ####   36 ####   35 #### #### #### #### ####
#### -190   15   20   29   67   38   69   35   30   30   30   35   69   38   67   29   20   15 -190 ####
#### #### #### #### ####   36 ####   38 #### #### #### #### ####   38 ####   36 #### #### #### #### ####
#### -198    2 -198 ####   35 ####   62   31   24   24   24   31   62 ####   35 #### -198    2 -198 ####
#### #### #### #### ####   37 ####   37 #### #### #### #### ####   37 ####   37 #### #### #### #### ####
####   26   20   24   32   68   37   61   33   39 ####   39   33   61   37   68   32   24   20   26 ####
####   15 #### #### ####   37 #### #### ####   30 ####   30 #### #### ####   37 #### #### ####   15 ####
####   24   15   26 ####   60   33   56   31   56   32   56   31   56   33   60 ####   26   15   24 ####
#### #### ####   18 ####   31 ####   27 #### #### #### #### ####   27 ####   31 ####   18 #### #### ####
####   26   18   45   23   36 ####   32   21   30 ####   30   21   32 ####   36   23   45   18   26 ####
####   15 #### #### #### #### #### #### ####   21 ####   21 #### #### #### #### #### #### ####   15 ####
####   24   13   12   13   14   16   18   20   47   22   47   20   18   16   14   13   12   13   24 ####
#### #### #### #### #### #### #### #### #### #### #### #### #### #### #### #### #### #### #### #### ####
