# === FIRST MAP ===
        layout = [
            "#####################",
            "#..P......#.........#",
            "#.###.###.#.###.###.#",
            "#.###.###.#.###.###.#",
            "#...................#",
            "#.###.#.#####.#.###.#",
            "#.....#...#...#.....#",
            "#####.###.#.###.#####",
            "#####.#.......#.#####",
            "#####.#.##.##.#.#####",
            "#.......#G..#.......#",
            "#####.#.#####.#.#####",
            "#####.#.......#.#####",
            "#####.#.#####.#.#####",
            "#.........#.........#",
            "#.###.###.#.###.###.#",
            "#...#...........#...#",
            "###.#.#.#####.#.#.###",
            "#.........#...#.....#",
            "#.#######.#.#######.#",
            "#...................#",
            "#####################",
         ]

# === SECOND MAP ===
         layout = [
            "#####################",
            "#.........#.........#",
            "#.###.###.#.###.###.#",
            "#.###.###.#.###.###.#",
            "#........P..........#",
            "#.###.#.#####.#.###.#",
            "#.....#...#...#.....#",
            "#####.###.#.###.#####",
            "#####.#.......#.#####",
            "#####.#.##.##.#.#####",
            "#.......#...#.......#",
            "#####.#.#####.#.#####",
            "#####.#.......#.#####",
            "#####.#.#####.#.#####",
            "#.........#.........#",
            "#.###.###.#.###.###.#",
            "#...#......G....#...#",
            "###.#.#.#####.#.#.###",
            "#.........#...#.....#",
            "#.#######.#.#######.#",
            "#...................#",
            "#####################",
         ]

# === THIRD MAP ===
         layout = [
            "#####################",
            "#.........#.........#",
            "#.###.###.#.###.###.#",
            "#.###.###.#.###.###.#",
            "#..........P........#",
            "#.###.#.#####.#.###.#",
            "#.....#...#...#.....#",
            "#####.###.#.###.#####",
            "#####.#.......#.#####",
            "#####.#.##.##.#.#####",
            "#.......#...#.......#",
            "#####.#.#####.#.#####",
            "#####.#.......#.#####",
            "#####.#.#####.#.#####",
            "#.........#.........#",
            "#.###.###.#.###.###.#",
            "#...#....G......#...#",
            "###.#.#.#####.#.#.###",
            "#.........#...#.....#",
            "#.#######.#.#######.#",
            "#...................#",
            "#####################",
         ]

# === FOURTH MAP ===
         layout = [
            "#####################",
            "#.........#.........#",
            "#.###.###.#.###.###.#",
            "#.###.###.#.###.###.#",
            "#...................#",
            "#.###.#.#####.#.###.#",
            "#.....#...#...#.....#",
            "#####.###.#.###.#####",
            "#####.#.......#.#####",
            "#####.#.##.##.#.#####",
            "#G......#...#.......#",
            "#####.#.#####.#.#####",
            "#####.#.......#P#####",
            "#####.#.#####.#.#####",
            "#.........#.........#",
            "#.###.###.#.###.###.#",
            "#...#...........#...#",
            "###.#.#.#####.#.#.###",
            "#.........#...#.....#",
            "#.#######.#.#######.#",
            "#...................#",
            "#####################",
         ]

# === GENERAL FAIR MAP ===
layout = [
    "#####################",
    "#.........#....P....#",
    "#.###.###.#.###.###.#",
    "#.###.###.#.###.###.#",
    "#...................#",
    "#.###.#.#####.#.###.#",
    "#.....#...#...#.....#",
    "#####.###.#.###.#####",
    "#####.#.......#.#####",
    "#####.#.##.##.#.#####",
    "#.......#...#.......#",
    "#####.#.#####.#.#####",
    "#####.#.......#.#####",
    "#####.#.#####.#.#####",
    "#.........#.........#",
    "#.###.###.#.###.###.#",
    "#...#...........#...#",
    "###.#.#.#####.#.#.###",
    "#....G....#...#.....#",
    "#.#######.#.#######.#",
    "#...................#",
    "#####################",
]
